#####################
#S  #   #   #     # #
### # ##### # ### # #
#       #   # #G# # #
### # # # ##### # # #
#   # #             #
# ######### # #######
#     #   # #   # # #
##### # # ##### # # #
#       #   #   #   #
##### ##### ##### ###
#         #   #     #
### ### ##### ### # #
# # #   # #     # # #
# # ##### # ### # # #
#   #     #   # # # #
### # # # ##### # ###
#   # # #         # #
# ### ### # # # ### #
#   #   # # # #     #
#####################
