#####################
#S    # # #     #   #
##### # # # ##### ###
# # #   #   #   #   #
# # # ### ### # ### #
#   #         # # # #
### # # ##### # # # #
#     #   #   #     #
####### ### ### # # #
#     # #G  # # # # #
### ##### ### # ### #
#           # # #   #
### # ### ### ### # #
#   #   #       # # #
# # # # # ### # #####
# # # # #   # #   # #
### ##### ######### #
#   #               #
##### # ##### ### # #
#     #     #   # # #
#####################
