#########
# #     #
# ### ###
# #     #
# # ### #
#   #S G#
### ### #
#     # #
#########

