#####################
#S      #       #G  #
####### # ### ##### #
#     # # #   # #   #
# # ### ##### # # ###
# #   # # #         #
# ##### # ####### ###
#       #     # #   #
# # ### # # ### ### #
# #   #   #   #   # #
# ### # # # ##### # #
# # # # # #       # #
# # ####### # # # # #
# # # # #   # # # # #
# # # # # ##### # # #
#     #       # #   #
# ####### ### # ### #
#   #   # #   #   # #
# ### # ####### # # #
#     #     #   # # #
#####################
