#######
#S#   #
# # # #
#   # #
### # #
#G    #
#######
